10 10
1111111111
1000000001
1011111101
1010001101
1011101101
1010001101
1011111101
1010000001
1011111111
1000000000
